13 31
###############################
#p        *   *    f          #
# # # #*# # #*#*# # # #*#*#*# #
#  x*     ***  *  1   * 2 * * #
# # # # # #*# # #*#*# # # # #*#
#f     *       *    *     1   #
# # # # # # # # # #*# #*# # # #
#    *    1      *     *      #
# #*# # #*# # # #*#*#*# # # # #
#*    **  *       *    *  2   #
# #*# # # # # # #*# # # # # # #
#     2     *   *  *          #
###############################
