13 31
###############################
#p  *  ***    3  *   *t*      #
# # # #*# # #*#*# # # #*#*#*# #
#**  * ***  *  1   * 2 * *    #
# # # # # #*# # #*#*# # # # #*#
# * 3 *   *      *      *     #
# # # # # # # # # #*# #*# # # #
#  *  *   *   *   *   2    #  #
# # # # #*# # # #*#*# #*# # # #
#*    **  *   *   *      *    #
# #*# #1# # # # #*# # # # # # #
# 3  *   *  *   *  *  1  x    #
###############################
