13 31
###############################
#p     ** *  7 *   *  * * *   #
# # # #*# # #*#*# # # #*#*#*# #
#  **   1 ***  *  b   * 2 * * #
# # # #*# #*# # #*#*# # # # #*#
#v  1 *   *x **  *  *   1     #
# # # #7# # # # # #*# #*# # # #
#*  *      *  *  *   *      v #
# # # # #*# # # #*#*# # #*# # #
#*    **  *  2    *     7     #
# #*# # # # # # #*# # #*# # # #
#    7      *   *  *  *     * #
###############################