13 31
###############################
#p  *  ***       *   *y*      #
# # # #*# # #*#*# # # #*#*#*# #
#**  * ***  *  1   * 2 * *    #
# # # # # #*# # #*#*# # # # #*#
# *   *   *      *      t     #
# # # # # # # # # #*# #*# # # #
#     *   *   *   *        #  #
# # # # #*# # # #*#*# # # # # #
#*    **  *       *           #
# #*# # # # # # #*# # # # # # #
#    *      *   *  *     x    #
###############################
