13 31
###############################
#p     ** *    *   *  * * *   #
# # # #*# # #*#*# # # #*#*#*# #
#  x*     ***  *      * 2 * * #
# # # # # #*# # #*#*# # # # #*#
#f         x **  *  *   1     #
# # # # # # # # # #*# #*# # # #
#*  *      *  *      *        #
# # # # #*# # # #*#*# # # # # #
#*    **  *       *           #
# #*# # # # # # #*# # # # # # #
#           *   *  *          #
###############################