13 31
###############################
#p  #  *    1  8  #       #   #
# # # # # # # # # # # # # #*# #
#s   *   f     *    *   #     #
# # # # ### # # #*# #*# # # #*#
#     8   *  *      *   *   # #
#*#*# # # # ### # # #*# # # #*#
#    *   x    *  #     2     *#
# # # # #*# # # # # # # # # #*#
##     #     *     8     #    #
# # # # # #*# # # # #*# # # # #
#   *   1       #  *    *     #
###############################