13 31
###############################
#p 7   e**   *  *   5  ****   #
# #*# # #*#*# #*# #*# # # # # #
# * ***  6   *   **    *   *  #
#*# # # #*# # #*# #*#*# #*#*# #
#  *   ***   * **     *   *   #
# # #*# # # #*# #*# # # #*# #*#
# **      **   *     **    *  #
#*# # # #*# # # # #*# # # # # #
#   **         ***       **   #
# #*# # #*# #*# # # # #*# # #*#
#  *    **   *    **    ***12 #
###############################
