13 31
###############################
#p          1       6         #
# # # # # # # # # # # # # # # #
#s       f                    #
# # # # # # # # # # #*# # # # #
#            *      *         #
# # # # # # # # # # # # # # # #
#        x                r   #
# # # # # # # # # # # # # # # #
#                             #
# # # #6# # # # # # # # # # # #
#                6            #
###############################