13 31
###############################
#p          1          *      #
# # # # # # #*# # # # # # # #*#
#v       5                    #
# # # # # # # # # # #*# # # # #
#            *      *         #
# # # # # # # # #*# # # #*# # #
#   *    x             1      #
# # # # # # # # # # #*# # # # #
#    5                      **#
# # # # #*# # # # # # # # # # #
#           5          *      #
###############################