15 20
####################
#             f    #
#             s    #
#             f    #
# *******f**f***** #
#                  #
# #   *            #
#                  #
# #                #
#                 x#
####################
####################
####################
####################
####################


