15 20
####################
#    y        f    #
#    t        s    #
#             b    #
# **************** #
#      ***         #
# #   *            #
#    1   1   1     #
# #                #
#          p      x#
####################
####################
####################
####################
####################


