15 20
####################
#             f    #
#             s    #
#             b    #
# **************** #
#      ***         #
# #   *            #
#                  #
# #                #
#                 x#
####################
####################
####################
####################
####################


