13 31
###############################
# p                           #
#       *                     #
#                             #
#                     #       #
#                             #
#                             #
#                             #
#           2                 #
#                             #
#                             #
#                             #
###############################