13 31
###############################
# p                           #
#                             #
#                             #
#                     #       #
#                             #
#                             #
#       3  4     5            #
#                             #
#                             #
#                             #
#                             #
###############################