13 31
###############################
#p   *  **   *  *      ****   #
# #*# # #*#*# #*# #*# # # # # #
# * ***  2   *   **    *   *  #
#*# # # #*# # #*# #*#*# #*#*# #
#  *   ***   * **  2  *   *   #
# # #*# # # #*# #*# # # #*# #*#
# **      **   *     **    *  #
#*# # # #*# # # # #*# # # # # #
#   **     2   ***       **   #
# #*# # #*# #*# # # # #*# # #*#
#  *    **   *    **    **    #
###############################
