13 31
###############################
#p   r  **   *  *      ****   #
# #*# # #*#*# #*# #*# # # # # #
# * ***      *   **    *   *  #
#*# # # #*# # #*# #*#*# #*#*# #
#  *   ***   * **     *   *   #
# # #*# # # #*# #*# # # #*# #*#
# **      **   *     **    *  #
#*# # # #*# # # # #*# # # # # #
#   **         ***       **   #
# #*# # #*# #*# # # # #*# # #*#
#  *    **   *    **    **    #
###############################
