13 31
###############################
#                             #
#                             #
#                             #
#    ####   #   #   ###       #
#    #      ##  #   #  #      #
#    ###    # # #   #  #      #
#    #      #  ##   #  #      #
#    ####   #   #   ###       #
#                             #
#                             #
#                             #
###############################
