13 31
###############################
#p     e**   *  *   4  ****   #
# #*# # #*#*# #*# #*# # # # # #
# * ***  4   *   **    *   *  #
#*# # # #*# # #*# #*#*# #*#*# #
#  *   ***   * **  1  *   *   #
# # #*# # # #*# #*# # # #*# #*#
# **   x  **   *     **    *  #
#*# # # #*# # # # #*# # # # # #
#   **     4   ***       **   #
# #*# # #*# #*# # # # #*# # #*#
#1 *    ** 2 *    **    ***1  #
###############################
