15 20
####################
#                  #
#             f    #
#                  #
# ************f*** #
#      *           #
# #   *            #
#                  #
# #                #
#                  #
####################
####################
####################
####################
####################


