15 20
####################
#                  #
#             s    #
#                  #
# **************** #
#                  #
# #   *            #
#                  #
# #                #
#                  #
####################
####################
####################
####################
####################


