15 20
####################
#p   y        f    #
#    t        s    #
#             b    #
# **************** #
#      ***         #
# #   *            #
#    1   1   1     #
# #                #
#                 x#
####################
####################
####################
####################
####################