20 30
##############################
#                   ##########
# # # # # # # # # # # # # ####
#                    #########
# #                 ##########
#                  ###########
# #                 ##########
#                   ##########
# #                 ##########
#                   ##########
##############################
##############################
##############################
##############################
##############################
##############################
##############################
##############################
##############################
##############################

