15 20
####################
#    y        f    #
#    f        f    #
#             f    #
# **************** #
#      ***         #
# #   *       3    #
#                  #
# #                #
#          p       #
# **************** #
# **************** #
# **************** #
# **************** #
####################