13 31
###############################
# p                           #
#                             #
#                             #
#                             #
#                             #
#           6                 #
#                             #
#                             #
#                             #
#                             #
#                             #
###############################